code	name	city	state
ALCH	Children's of Alabama	Birmingham	AL
ALUA	University of Alabama Hospital	Birmingham	AL
ALVA	Birmingham VA Medical Center	Birmingham	AL
ARBH	Baptist Medical Center	Little Rock	AR
ARCH	Arkansas Children's Hospital	Little Rock	AR
ARUA	UAMS Medical Center	Little Rock	AR
AZCH	Phoenix Children's Hospital	Phoenix	AZ
AZGS	Banner-University Medical Center Phoenix	Phoenix	AZ
AZMC	Mayo Clinic Hospital Arizona	Phoenix	AZ
AZSJ	St. Joseph's Hospital and Medical Center	Phoenix	AZ
AZUA	Banner University Medical Center-Tucson	Tucson	AZ
CACH	Rady Children's Hospital and Health Center	San Diego	CA
CACL	Children's Hospital Los Angeles	Los Angeles	CA
CACS	Cedars-Sinai Medical Center	Los Angeles	CA
CAGH	Scripps Green Hospital	La Jolla	CA
CAHP	City of Hope National Medical Center	Duarte	CA
CAIM	University of California Irvine Medical Center	Orange	CA
CALA	Harbor UCLA Medical Center	Torrance	CA
CALL	Loma Linda University Medical Center	Loma Linda	CA
CAMB	UCSF Medical Center at Mission Bay	San Francisco	CA
CAPC	Lucile Salter Packard Children's Hospital at Stanford	Palo Alto	CA
CAPM	California Pacific Medical Center-Van Ness Campus	San Francisco	CA
CASD	University of California San Diego Medical Center	La Jolla	CA
CASF	University of California San Francisco Medical Center	San Francisco	CA
CASG	Sutter Medical Center Sacramento	Sacramento	CA
CASH	Sharp Memorial Hospital	San Diego	CA
CASJ	Saint Joseph Hospital	Orange	CA
CASM	University of California Davis Medical Center	Sacramento	CA
CASU	Stanford Health Care	Stanford	CA
CAUC	University of California at Los Angeles Medical Center	Los Angeles	CA
CAUH	Keck Hospital of USC	Los Angeles	CA
COCH	Children's Hospital Colorado	Aurora	CO
COPM	AdventHealth Porter	Denver	CO
COSL	Presbyterian/St Luke's Medical Center	Denver	CO
COUC	University of Colorado Hospital/Health Science Center	Aurora	CO
CTHH	Hartford Hospital	Hartford	CT
CTYN	Yale New Haven Hospital	New Haven	CT
DCCH	Children's National Medical Center	Washington	DC
DCGU	Medstar Georgetown Transplant Institute	Washington	DC
DCGW	George Washington University Hospital	Washington	DC
DCWH	Washington Hospital Center	Washington	DC
DCWR	Walter Reed National Military Medical Center at Bethesda	Bethesda	MD
DEAI	Nemours Children's Hospital Delaware	Wilmington	DE
DECC	Christiana Care Health Services	Newark	DE
FLAC	Johns Hopkins All Children's Hospital	St. Petersburg	FL
FLCC	Cleveland Clinic Florida Weston	Weston	FL
FLFH	AdventHealth Orlando	Orlando	FL
FLHM	Halifax Health	Daytona Beach	FL
FLJD	Memorial Regional Hospital/Joe DiMaggio Children's Hospital	Hollywood	FL
FLJM	Jackson Memorial Hospital University of Miami School of Medicine	Miami	FL
FLLM	Largo Medical Center	Largo	FL
FLMR	Memorial Regional Hospital	Hollywood	FL
FLSH	Ascension Sacred Heart Pensacola	Pensacola	FL
FLSL	Mayo Clinic Hospital Florida	Jacksonville	FL
FLTG	Tampa General Hospital	Tampa	FL
FLUF	UF Health Shands Hospital	Gainesville	FL
GAEH	Children’s Healthcare of Atlanta - Arthur M. Blank Hospital	Atlanta	GA
GAEM	Emory University Hospital	Atlanta	GA
GAMC	Wellstar MCG Health, affiliated with Medical College of Georgia	Augusta	GA
GAPH	Piedmont Hospital	Atlanta	GA
HIQM	The Queen's Medical Center	Honolulu	HI
IAIM	Iowa Methodist Medical Center	Des Moines	IA
IAIV	University of Iowa Hospitals and Clinics Transplant Programs	Iowa City	IA
IAVA	The Iowa City VA Health Care System	Iowa City	IA
ILCH	Advocate Christ Medical Center	Oak Lawn	IL
ILCM	Ann & Robert H. Lurie Children's Hospital of Chicago	Chicago	IL
ILLU	Loyola University Medical Center	Maywood	IL
ILMM	Springfield Memorial Hospital	Springfield	IL
ILNM	Northwestern Memorial Hospital	Chicago	IL
ILPL	Rush University Medical Center	Chicago	IL
ILSF	OSF Saint Francis Medical Center	Peoria	IL
ILUC	University of Chicago Medical Center	Chicago	IL
ILUI	University of Illinois Medical Center	Chicago	IL
ILVA	Edward Hines Jr. Veterans Administration Medical Center	Hines	IL
INIM	Indiana University Health	Indianapolis	IN
INSV	Ascension St. Vincent Hospital	Indianapolis	IN
KSUK	University of Kansas Hospital	Kansas City	KS
KYJH	Jewish Hospital	Louisville	KY
KYKC	Norton Children's Hospital	Louisville	KY
KYUK	University of Kentucky Medical Center	Lexington	KY
LACH	Children's Hospital	New Orleans	LA
LAOF	Ochsner Foundation Hospital	New Orleans	LA
LATU	Tulane Medical Center	Metairie	LA
LAWK	Willis-Knighton Medical Center	Shreveport	LA
MABI	Beth Israel Deaconess Medical Center	Boston	MA
MABS	Baystate Medical Center	Springfield	MA
MABU	Boston Medical Center	Boston	MA
MACH	Boston Children's Hospital	Boston	MA
MALC	Lahey Clinic Medical Center	Burlington	MA
MAMG	Massachusetts General Hospital	Boston	MA
MANM	Tufts Medical Center	Boston	MA
MAPB	Brigham and Women's Hospital	Boston	MA
MAUM	UMass Memorial Medical Center	Worcester	MA
MDJH	Johns Hopkins Hospital	Baltimore	MD
MDUM	University of Maryland Medical System	Baltimore	MD
MEMC	Maine Medical Center	Portland	ME
MIBH	Corewell Health William Beaumont University Hospital	Royal Oak	MI
MICH	Children's Hospital of Michigan	Detroit	MI
MIDV	Corewell Health Helen DeVos Children's Hospital	Grand Rapids	MI
MIHF	Henry Ford Hospital	Detroit	MI
MISH	Corewell Health Grand Rapids Hospitals	Grand Rapids	MI
MISJ	Ascension St. John Hospital	Detroit	MI
MISM	Mercy Health Saint Mary's	Grand Rapids	MI
MIUM	University of Michigan Medical Center	Ann Arbor	MI
MNAN	Abbott Northwestern Hospital	Minneapolis	MN
MNCM	Children's Minnesota	Minneapolis	MN
MNHC	Hennepin County Medical Center	Minneapolis	MN
MNMC	Mayo Clinic Hospital Minnesota	Rochester	MN
MNUM	University of Minnesota Medical Center, Fairview	Minneapolis	MN
MOBH	Barnes-Jewish Hospital	St. Louis	MO
MOCG	Cardinal Glennon Children's Hospital	St. Louis	MO
MOCH	St. Louis Children's Hospital at Washington University Medical Center	St. Louis	MO
MOCM	Children's Mercy Hospital	Kansas City	MO
MOLH	St Luke's Hospital of Kansas City	Kansas City	MO
MORH	Research Medical Center	Kansas City	MO
MOSL	SSM Health Saint Louis University Hospital	St. Louis	MO
MOUM	University of Missouri Hospital and Clinics	Columbia	MO
MSUM	University of Mississippi Medical Center	Jackson	MS
NCBG	Wake Forest Baptist Medical Center	Winston-Salem	NC
NCCM	Carolinas Medical Center	Charlotte	NC
NCDU	Duke University Hospital	Durham	NC
NCEC	ECU Health Medical Center	Greenville	NC
NCMH	University of North Carolina Hospitals	Chapel Hill	NC
NDMC	Sanford Bismarck Medical Center	Bismarck	ND
NDSL	Sanford Medical Center Fargo	Fargo	ND
NECH	Children’s Nebraska	Omaha	NE
NEUN	The Nebraska Medical Center	Omaha	NE
NHDH	Mary Hitchcock Memorial Hospital	Lebanon	NH
NJBI	Newark Beth Israel Medical Center	Newark	NJ
NJHK	Hackensack University Medical Center	Hackensack	NJ
NJLL	Virtua Our Lady of Lourdes Hospital	Camden	NJ
NJRW	Robert Wood Johnson University Hospital	New Brunswick	NJ
NJSB	Saint Barnabas Medical Center	Livingston	NJ
NJUH	University Hospital	Newark	NJ
NMAQ	University Hospital, University of New Mexico Health Sciences Center	Albuquerque	NM
NMPH	Presbyterian Hospital	Albuquerque	NM
NVUM	University Medical Center of Southern Nevada	Las Vegas	NV
NYAM	Albany Medical Center Hospital	Albany	NY
NYCC	Long Island Jewish Medical Center-Cohen Children's Medical Center	Queens	NY
NYCP	NY Presbyterian Hospital/Columbia Univ. Medical Center	New York	NY
NYDS	State University of New York, Downstate Medical Center	Brooklyn	NY
NYEC	Erie County Medical Center	Buffalo	NY
NYFL	Strong Memorial Hospital, University of Rochester Medical Center	Rochester	NY
NYMA	Montefiore Medical Center	Bronx	NY
NYMS	Mount Sinai Medical Center	New York	NY
NYNS	North Shore University Hospital/Northwell Health	Manhasset	NY
NYNY	New York-Presbyterian Hospital/Weill Cornell Medical Center	New York	NY
NYSB	University Hospital of State University of New York at Stony Brook	Stony Brook	NY
NYUC	NYU Langone Health	New York	NY
NYUM	State University of New York Upstate Medical University	Syracuse	NY
NYVA	James J. Peters VA Medical Center	Bronx	NY
NYWC	Westchester Medical Center	Valhalla	NY
OHCC	The Cleveland Clinic Foundation	Cleveland	OH
OHCH	Nationwide Children's Hospital	Columbus	OH
OHCM	Children's Hospital Medical Center	Cincinnati	OH
OHCO	University of Toledo Medical Center	Toledo	OH
OHOU	Ohio State University Medical Center	Columbus	OH
OHTC	The Christ Hospital	Cincinnati	OH
OHUC	University of Cincinnati Medical Center	Cincinnati	OH
OHUH	University Hospitals of Cleveland	Cleveland	OH
OKBC	Integris Baptist Medical Center	Oklahoma City	OK
OKCM	Children's Hospital of Oklahoma	Oklahoma City	OK
OKMD	OU Medical Center	Oklahoma City	OK
OKSJ	St John Medical Center	Tulsa	OK
ORGS	Legacy Good Samaritan Hospital and Medical Center	Portland	OR
ORSV	Providence St. Vincent Medical Center	Portland	OR
ORUO	Oregon Health and Science University	Portland	OR
ORVA	VA Portland Health Care System	Portland	OR
PAAE	Albert Einstein Medical Center	Philadelphia	PA
PAAG	Allegheny General Hospital	Pittsburgh	PA
PACH	UPMC Children's Hospital of Pittsburgh	Pittsburgh	PA
PACP	Children's Hospital of Philadelphia	Philadelphia	PA
PAGM	Geisinger Medical Center	Danville	PA
PAHE	Penn State Milton S Hershey Medical Center	Hershey	PA
PAHH	Pinnacle Health System at Harrisburg Hospital	Harrisburg	PA
PAHM	Hahnemann University Hospital	Philadelphia	PA
PALV	Lehigh Valley Hospital	Allentown	PA
PAPH	UPMC Hamot	Erie	PA
PAPT	University of Pittsburgh Medical Center	Pittsburgh	PA
PASC	St. Christopher's Hospital for Children	Philadelphia	PA
PATJ	Thomas Jefferson University Hospital	Philadelphia	PA
PATU	Temple University Hospital	Philadelphia	PA
PAUP	Hospital of the University of Pennsylvania	Philadelphia	PA
PAVA	VA Pittsburgh Healthcare System	Pittsburgh	PA
PRCC	Cardiovascular Center of Puerto Rico and the Caribbean	San Juan	PR
PRSJ	Auxilio Mutuo Hospital	Hato Rey	PR
RIRH	Rhode Island Hospital	Providence	RI
SCCH	MUSC Children's Hospital	Charleston	SC
SCLA	MUSC Lancaster	Lancaster	SC
SCMU	Medical University of South Carolina	Charleston	SC
SCPG	Prisma Health Greenville Memorial Hospital	Greenville	SC
SDMK	Avera McKennan Hospital	Sioux Falls	SD
SDSV	Sanford Health/USD Medical Center	Sioux Falls	SD
TNBM	Baptist Memorial Hospital	Memphis	TN
TNEM	Erlanger Medical Center	Chattanooga	TN
TNLB	Le Bonheur Children's Medical Center	Memphis	TN
TNMH	Methodist University Hospital	Memphis	TN
TNST	Saint Thomas Hospital	Nashville	TN
TNUK	University of Tennessee Medical Center at Knoxville	Knoxville	TN
TNVU	Vanderbilt University Medical Center	Nashville	TN
TXAS	Baylor Scott and White All Saints Medical Center-Fort Worth	Fort Worth	TX
TXBC	University Hospital, University of Texas Health Science Center	San Antonio	TX
TXCF	Cook Children's Medical Center	Fort Worth	TX
TXCM	Children's Medical Center of Dallas	Dallas	TX
TXCT	Seton Medical Center Austin	Austin	TX
TXDC	Driscoll Children's Hospital	Corpus Christi	TX
TXDL	Dell Children's Medical Center	Austin	TX
TXDM	North Austin Medical Center	Austin	TX
TXDR	Doctor's Hospital at Renaissance	Edinburg	TX
TXDS	Dell Seton Medical Center at The University of Texas at Austin	Austin	TX
TXFW	Texas Health Harris Methodist Fort Worth Hospital	Fort Worth	TX
TXHD	Medical City Dallas Hospital	Dallas	TX
TXHH	Memorial Hermann Hospital, University of Texas at Houston	Houston	TX
TXHI	CHI St. Luke's Health Baylor College of Medicine Medical Center	Houston	TX
TXHS	Methodist Specialty and Transplant Hospital	San Antonio	TX
TXJS	University of Texas Medical Branch at Galveston	Galveston	TX
TXLM	Covenant Medical Center	Lubbock	TX
TXLP	Las Palmas Medical Center	El Paso	TX
TXMC	Methodist Dallas Medical Center	Dallas	TX
TXMH	Houston Methodist Hospital	Houston	TX
TXPL	Medical City Fort Worth	Fort Worth	TX
TXPM	Parkland Health and Hospital System	Dallas	TX
TXSP	UT Southwestern Medical Center/William P. Clements Jr. University Hospital	Dallas	TX
TXSW	Scott and White Memorial Hospital	Temple	TX
TXTC	Texas Children's Hospital	Houston	TX
TXTX	Baylor University Medical Center	Dallas	TX
TXUC	University Children's Health	San Antonio	TX
TXVA	Michael E. DeBakey VA Medical Center	Houston	TX
UTLD	Intermountain Medical Center	Murray	UT
UTMC	University of Utah Medical Center	Salt Lake City	UT
UTPC	Primary Children's Hospital	Salt Lake City	UT
VACH	Children's Hospital of the King's Daughters	Norfolk	VA
VAFH	Inova Fairfax Hospital	Falls Church	VA
VAHD	Henrico Doctors' Hospital	Richmond	VA
VAMC	VCU Health System Authority, VCUMC	Richmond	VA
VAMV	Hunter Holmes McGuire Veterans Administration Medical Center (inactive *)	Richmond	VA
VANG	Sentara Norfolk General Hospital	Norfolk	VA
VAUV	University of Virginia Health Sciences Center	Charlottesville	VA
VTMC	The University of Vermont Medical Center	Burlington	VT
WACH	Seattle Children's Hospital	Seattle	WA
WASH	Providence Sacred Heart Medical Center & Children's Hospital	Spokane	WA
WASM	Swedish Medical Center	Seattle	WA
WAUW	University of Washington Medical Center	Seattle	WA
WAVM	Virginia Mason Medical Center	Seattle	WA
WICH	Children's Hospital of Wisconsin	Milwaukee	WI
WISE	Froedtert Memorial Lutheran Hospital	Milwaukee	WI
WISL	Aurora St. Luke's Medical Center	Milwaukee	WI
WIUW	University of Wisconsin Hospital and Clinics	Madison	WI
WVCA	Charleston Area Medical Center	Charleston	WV
WVWU	West Virginia University Hospitals Inc.	Morgantown	WV